30x10
##############################
#P      #        T         S#
# ####### ###### ######### ##
#     T #      #         #  #
##### # ###### ##### ## # ###
#   # #      # A   # ## #   #
# # # ###### ##### # ## ### #
# #        #     T #        #
# ######## ######### ###### #
##############################