##############################
#P        T        #        S#
# ####### ######## # ####### #
#       #        # #       # #
# ##### # ###### # ##### # # #
#     # #      # #     # #   #
### # # ###### # ##### # #####
#   # #    T   #     # #     #
# A   #######        #       #
##############################